11100011101000000000000000010100
11100011101000000001101000000001
11100011101000000010000100000011
11100000100100100011000000000010
11100000101000000100000000000000
11100000010001000101000100000100
11100000110000000110000010100000
11100001100001010111000101000010
11100000000001111000000000000011
11100001111000001001000000000110
11100000001001001010000000000101
11100001010110000000000000000110
00010000100000010001000000000001
11100001000110010000000000001000
00000000100000100010000000000010
11100011101000000000101100000001
11100100100000000001000000000000
11100100100100001011000000000000
11100100100000000010000000000100
11100100100000000011000000001000
11100100100000000100000000001101
11100100100000000101000000010000
11100100100000000110000000010100
11100100100100001010000000000100
11100100100000000111000000011000
11100011101000000001000000000100
11100011101000000010000000000000
11100011101000000011000000000000
11100000100000000100000100000011
11100100100101000101000000000000
11100100100101000110000000000100
11100001010101010000000000000110
11000100100001000110000000000000
11000100100001000101000000000100
11100010100000110011000000000001
11100011010100110000000000000011
10111010111111111111111111110111
11100010100000100010000000000001
11100001010100100000000000000001
10111010111111111111111111110011
11100100100100000001000000000000
11100100100100000010000000000100
11100100100100000011000000001000
11100100100100000100000000001100
11100100100100000101000000010000
11100100100100000110000000010100
11101010111111111111111111111111